 ##########################################################################
       #       #             #       #       #             #       #       
###### ####### ####### ##### ####### ####### ####### ##### ####### ####### 
#      ##      ##            ##      ##      ##            ##      ##      
# ####### ####### ##### ####### ####### ####### ##### ####### ####### #####
#              ##                    ##      ##                    ##      
###### ####### ####### ##### ####### ####### ####### ##### ####### ####### 
#      ##                    ##                            ##              
###### ####### ####### ##### ####### ####### ####### ##### ####### ####### 
#      ##      ##            ##      ##      ##            ##      ##      
########## ##################### ############################# ############
       #       #             #       #       #             #       #       
###### ####### ####### ##### ####### ####### ####### ##### ####### ####### 
#      ##      ##            ##      ##      ##            ##      ##      
# ####### ####### ##### ####### ####### ####### ##### ####### ####### #####
#              ##                    ##      ##                    ##      
###### ####### ####### ##### ####### ####### ####### ##### ####### ####### 
#      ##                    ##                            ##              
###### ####### ####### ##### ####### ####### ####### ##### ####### ####### 
#      ##      ##            ##      ##      ##            ##      ##      
############ ##################### ############################# ##########
       #       #             #       #       #             #       #       
###### ####### ####### ##### ####### ####### ####### ##### ####### ####### 
#      ##      ##            ##      ##      ##            ##      ##      
# ####### ####### ##### ####### ####### ####### ##### ####### ####### #####
#              ##                    ##      ##                    ##      
###### ####### ####### ##### ####### ####### ####### ##### ####### ####### 
#      ##                    ##                            ##              
###### ####### ####### ##### ####### ####### ####### ##### ####### ####### 
#      ##      ##            ##      ##      ##            ##      ##      
# ####### ####### ##### ####### ####### ####### ##### ####### ####### #####
############################### ###########################################
       #       #             #       #       #             #       #       
###### ####### ####### ##### ####### ####### ####### ##### ####### ####### 
#      ##      ##            ##      ##      ##            ##      ##      
# ####### ####### ##### ####### ####### ####### ##### ####### ####### #####
#              ##                    ##      ##                    ##      
###### ####### ####### ##### ####### ####### ####### ##### ####### ####### 
#      ##                    ##                            ##              
###### ####### ####### ##### ####### ####### ####### ##### ####### ####### 
#      ##      ##            ##      ##      ##            ##      ##      
########## ##################### ############################# ############
       #       #             #       #       #             #       #       
###### ####### ####### ##### ####### ####### ####### ##### ####### ####### 
#      ##      ##            ##      ##      ##            ##      ##      
# ####### ####### ##### ####### ####### ####### ##### ####### ####### #####
#              ##                    ##      ##                    ##      
###### ####### ####### ##### ####### ####### ####### ##### ####### ####### 
#      ##                    ##                            ##              
###### ####### ####### ##### ####### ####### ####### ##### ####### ####### 
#      ##      ##            ##      ##      ##            ##      ##      
############ ##################### ############################# ##########
       #       #             #       #       #             #       #       
###### ####### ####### ##### ####### ####### ####### ##### ####### ####### 
#      ##      ##            ##      ##      ##            ##      ##      
# ####### ####### ##### ####### ####### ####### ##### ####### ####### #####
#              ##                    ##      ##                    ##      
###### ####### ####### ##### ####### ####### ####### ##### ####### ####### 
#      ##                    ##                            ##              
###### ####### ####### ##### ####### ####### ####### ##### ####### ####### 
#      ##      ##            ##      ##      ##            ##      ##      
# ####### ####### ##### ####### ####### ####### ##### ####### ####### #####
