 ##########
          #
######### #
#         #
# #########
#         #
######### #
#         #
#########  
